{"id":"SShape",
"ename":"River_Drift",
"name":"扭转河",
"width":17,
"height":25,
"point_type":[
  [0,0,0,0,0,1,1,1,1,1,1,1,1,1,1,1,1],
  [0,0,0,0,0,1,1,1,1,1,1,1,1,1,1,1,1],
  [0,0,0,0,0,1,1,1,1,1,1,1,1,1,1,1,1],
  [0,0,0,0,0,1,1,1,1,1,1,1,1,13,1,1,1],
  [0,0,0,0,0,1,1,1,1,1,1,1,1,1,1,1,1],
  [0,0,0,0,0,1,1,1,1,1,1,1,1,1,1,1,1],
  [0,0,0,0,0,1,1,1,1,1,1,1,1,1,1,1,1],
  [0,0,0,0,0,1,1,1,1,1,1,1,0,0,0,0,0],
  [0,0,0,0,0,1,1,1,1,1,1,1,0,0,0,0,0],
  [0,0,0,0,0,1,1,1,1,1,1,1,0,0,0,0,0],
  [0,0,0,0,0,1,1,1,1,1,1,1,0,0,0,0,0],
  [0,0,0,0,0,1,1,1,1,1,1,1,0,0,0,0,0],
  [0,0,0,0,0,1,1,1,1,1,1,1,0,0,0,0,0],
  [0,0,0,0,0,1,1,1,1,1,1,1,0,0,0,0,0],
  [0,0,0,0,0,1,1,1,1,1,1,1,0,0,0,0,0],
  [0,0,0,0,0,1,1,1,1,1,1,1,0,0,0,0,0],
  [0,0,0,0,0,1,1,1,1,1,1,1,0,0,0,0,0],
  [0,0,0,0,0,1,1,1,1,1,1,1,0,0,0,0,0],
  [1,1,1,1,1,1,1,1,1,1,1,1,0,0,0,0,0],
  [1,1,1,1,1,1,1,1,1,1,1,1,0,0,0,0,0],
  [1,1,1,1,1,1,1,1,1,1,1,1,0,0,0,0,0],
  [1,1,1,11,1,1,1,1,1,1,1,1,0,0,0,0,0],
  [1,1,1,1,1,1,1,1,1,1,1,1,0,0,0,0,0],
  [1,1,1,1,1,1,1,1,1,1,1,1,0,0,0,0,0],
  [1,1,1,1,1,1,1,1,1,1,1,1,0,0,0,0,0]
]}

