{"id":"WDiamond",
"ename":"Double_Gemini",
"name":"双子岛",
"width":17,
"height":25,
"point_type":[
  [0,0,0,0,0,0,0,0,1,0,0,0,0,0,0,0,0],
  [0,0,0,0,0,0,0,1,1,1,0,0,0,0,0,0,0],
  [0,0,0,0,0,0,1,1,1,1,1,0,0,0,0,0,0],
  [0,0,0,0,0,1,1,1,1,1,1,1,0,0,0,0,0],
  [0,0,0,0,1,1,1,1,1,1,1,1,1,0,0,0,0],
  [0,0,0,1,1,1,1,1,13,1,1,1,1,1,0,0,0],
  [0,0,1,1,1,1,1,1,1,1,1,1,1,1,1,0,0],
  [0,1,1,1,1,1,1,1,1,1,1,1,1,1,1,1,0],
  [1,1,1,1,1,1,1,1,1,1,1,1,1,1,1,1,1],
  [0,1,1,1,1,1,1,1,1,1,1,1,1,1,1,1,0],
  [0,0,1,1,1,1,1,1,1,1,1,1,1,1,1,0,0],
  [0,0,0,1,1,1,1,1,1,1,1,1,1,1,0,0,0],
  [0,0,0,0,1,1,1,1,1,1,1,1,1,0,0,0,0],
  [0,0,0,1,1,1,1,1,1,1,1,1,1,1,0,0,0],
  [0,0,1,1,1,1,1,1,1,1,1,1,1,1,1,0,0],
  [0,1,1,1,1,1,1,1,1,1,1,1,1,1,1,1,0],
  [1,1,1,1,1,1,1,1,1,1,1,1,1,1,1,1,1],
  [0,1,1,1,1,1,1,1,1,1,1,1,1,1,1,1,0],
  [0,0,1,1,1,1,1,1,1,1,1,1,1,1,1,0,0],
  [0,0,0,1,1,1,1,1,11,1,1,1,1,1,0,0,0],
  [0,0,0,0,1,1,1,1,1,1,1,1,1,0,0,0,0],
  [0,0,0,0,0,1,1,1,1,1,1,1,0,0,0,0,0],
  [0,0,0,0,0,0,1,1,1,1,1,0,0,0,0,0,0],
  [0,0,0,0,0,0,0,1,1,1,0,0,0,0,0,0,0],
  [0,0,0,0,0,0,0,0,1,0,0,0,0,0,0,0,0]
]}

