{"id":"Zigzag",
"ename":"Thunder_Point",
"name":"À×öª³µÕ¾",
"width":16,
"height":26,
"point_type":[
  [0,0,0,0,0,0,0,0,1,1,1,1,1,1,1,1],
  [0,0,0,0,0,0,0,0,1,1,1,1,1,1,1,1],
  [0,0,0,0,0,0,0,0,1,1,1,1,1,1,1,1],
  [0,0,0,0,0,0,0,0,1,1,1,1,13,1,1,1],
  [0,0,0,0,0,0,0,0,1,1,1,1,1,1,1,1],
  [0,0,0,0,0,0,0,0,1,1,1,1,1,1,1,1],
  [0,0,0,0,0,0,0,0,1,1,1,1,1,1,1,1],
  [1,1,1,1,1,1,1,1,1,1,1,1,1,1,1,1],
  [1,1,1,1,1,1,1,1,1,1,1,1,1,1,1,1],
  [1,1,1,1,1,1,1,1,1,1,1,1,1,1,1,1],
  [1,1,1,1,1,1,1,1,1,1,1,1,1,1,1,1],
  [1,1,1,1,1,1,1,1,1,1,1,1,1,1,1,1],
  [1,1,1,1,1,1,1,1,1,1,1,1,1,1,1,1],
  [1,1,1,1,1,1,1,1,1,1,1,1,1,1,1,1],
  [1,1,1,1,1,1,1,1,1,1,1,1,1,1,1,1],
  [1,1,1,1,1,1,1,1,1,1,1,1,1,1,1,1],
  [1,1,1,1,1,1,1,1,1,1,1,1,1,1,1,1],
  [1,1,1,1,1,1,1,1,1,1,1,1,1,1,1,1],
  [1,1,1,1,1,1,1,1,1,1,1,1,1,1,1,1],
  [1,1,1,1,1,1,1,1,0,0,0,0,0,0,0,0],
  [1,1,1,1,1,1,1,1,0,0,0,0,0,0,0,0],
  [1,1,1,1,1,1,1,1,0,0,0,0,0,0,0,0],
  [1,1,1,11,1,1,1,1,0,0,0,0,0,0,0,0],
  [1,1,1,1,1,1,1,1,0,0,0,0,0,0,0,0],
  [1,1,1,1,1,1,1,1,0,0,0,0,0,0,0,0],
  [1,1,1,1,1,1,1,1,0,0,0,0,0,0,0,0]
]}

