{"id":"Cross",
"ename":"X_Marks_the_Garden",
"name":"·£·Ö»¨Ô°",
"width":19,
"height":23,
"point_type":[
  [0,0,0,0,0,0,1,1,1,1,1,1,1,0,0,0,0,0,0],
  [0,0,0,0,0,0,1,1,1,1,1,1,1,0,0,0,0,0,0],
  [0,0,0,0,0,0,1,1,1,1,1,1,1,0,0,0,0,0,0],
  [0,0,0,0,0,0,1,1,1,13,1,1,1,0,0,0,0,0,0],
  [0,0,0,0,0,0,1,1,1,1,1,1,1,0,0,0,0,0,0],
  [0,0,0,0,0,0,1,1,1,1,1,1,1,0,0,0,0,0,0],
  [0,0,0,0,0,0,1,1,1,1,1,1,1,0,0,0,0,0,0],
  [0,0,0,0,0,0,1,1,1,1,1,1,1,0,0,0,0,0,0],
  [1,1,1,1,1,1,1,1,1,1,1,1,1,1,1,1,1,1,1],
  [1,1,1,1,1,1,1,1,1,1,1,1,1,1,1,1,1,1,1],
  [1,1,1,1,1,1,1,1,1,1,1,1,1,1,1,1,1,1,1],
  [1,1,1,1,1,1,1,1,1,1,1,1,1,1,1,1,1,1,1],
  [1,1,1,1,1,1,1,1,1,1,1,1,1,1,1,1,1,1,1],
  [1,1,1,1,1,1,1,1,1,1,1,1,1,1,1,1,1,1,1],
  [1,1,1,1,1,1,1,1,1,1,1,1,1,1,1,1,1,1,1],
  [0,0,0,0,0,0,1,1,1,1,1,1,1,0,0,0,0,0,0],
  [0,0,0,0,0,0,1,1,1,1,1,1,1,0,0,0,0,0,0],
  [0,0,0,0,0,0,1,1,1,1,1,1,1,0,0,0,0,0,0],
  [0,0,0,0,0,0,1,1,1,1,1,1,1,0,0,0,0,0,0],
  [0,0,0,0,0,0,1,1,1,11,1,1,1,0,0,0,0,0,0],
  [0,0,0,0,0,0,1,1,1,1,1,1,1,0,0,0,0,0,0],
  [0,0,0,0,0,0,1,1,1,1,1,1,1,0,0,0,0,0,0],
  [0,0,0,0,0,0,1,1,1,1,1,1,1,0,0,0,0,0,0]
]}

