{"id":"IShape",
"ename":"Girder_for_Battle",
"name":"¸Ö¹Ç½¨Öþ",
"width":17,
"height":18,
"point_type":[
  [1,1,1,1,1,1,1,1,13,1,1,1,1,1,1,1,1],
  [1,1,1,1,1,1,1,1,1,1,1,1,1,1,1,1,1],
  [1,1,1,1,1,1,1,1,1,1,1,1,1,1,1,1,1],
  [1,1,1,1,1,1,1,1,1,1,1,1,1,1,1,1,1],
  [1,1,1,1,1,1,1,1,1,1,1,1,1,1,1,1,1],
  [1,1,1,1,1,1,1,1,1,1,1,1,1,1,1,1,1],
  [0,0,0,0,0,1,1,1,1,1,1,1,0,0,0,0,0],
  [0,0,0,0,0,1,1,1,1,1,1,1,0,0,0,0,0],
  [0,0,0,0,0,1,1,1,1,1,1,1,0,0,0,0,0],
  [0,0,0,0,0,1,1,1,1,1,1,1,0,0,0,0,0],
  [0,0,0,0,0,1,1,1,1,1,1,1,0,0,0,0,0],
  [0,0,0,0,0,1,1,1,1,1,1,1,0,0,0,0,0],
  [1,1,1,1,1,1,1,1,1,1,1,1,1,1,1,1,1],
  [1,1,1,1,1,1,1,1,1,1,1,1,1,1,1,1,1],
  [1,1,1,1,1,1,1,1,1,1,1,1,1,1,1,1,1],
  [1,1,1,1,1,1,1,1,1,1,1,1,1,1,1,1,1],
  [1,1,1,1,1,1,1,1,1,1,1,1,1,1,1,1,1],
  [1,1,1,1,1,1,1,1,11,1,1,1,1,1,1,1,1]
]}

