{"id":"Stairs",
"ename":"Cracker_Snap",
"name":"Çå´à±ý¸É",
"width":14,
"height":20,
"point_type":[
  [0,0,1,1,1,1,1,1,1,1,1,1,1,1],
  [0,0,1,1,1,1,1,1,1,1,1,1,1,1],
  [0,0,1,1,1,1,1,1,1,1,1,13,1,1],
  [0,0,1,1,1,1,1,1,1,1,1,1,1,1],
  [0,0,1,1,1,1,1,1,1,1,1,1,1,1],
  [1,1,0,0,1,1,1,1,1,1,1,1,1,1],
  [1,1,0,0,1,1,1,1,1,1,1,1,1,1],
  [1,1,1,1,0,0,1,1,1,1,1,1,1,1],
  [1,1,1,1,0,0,1,1,1,1,1,1,1,1],
  [1,1,1,1,1,1,0,0,1,1,1,1,1,1],
  [1,1,1,1,1,1,0,0,1,1,1,1,1,1],
  [1,1,1,1,1,1,1,1,0,0,1,1,1,1],
  [1,1,1,1,1,1,1,1,0,0,1,1,1,1],
  [1,1,1,1,1,1,1,1,1,1,0,0,1,1],
  [1,1,1,1,1,1,1,1,1,1,0,0,1,1],
  [1,1,1,1,1,1,1,1,1,1,1,1,0,0],
  [1,1,1,1,1,1,1,1,1,1,1,1,0,0],
  [1,1,11,1,1,1,1,1,1,1,1,1,0,0],
  [1,1,1,1,1,1,1,1,1,1,1,1,0,0],
  [1,1,1,1,1,1,1,1,1,1,1,1,0,0]
]}

